F 0, 120, 10
EA ./srcs/textures/greystone.xpm
WE ./srcs/textures/bluestone.xpm
NO ./srcs/textures/wood.xpm
SO ./srcs/textures/redbrick.xpm
C 225, 30, 0
S ./srcs/textures/barrel.xpm
R 400 4000

 1  
11111111111111111
10000002000000001111111111
10000000000000001111111111
10000000000000001 1
100000000000000011
10000000000000001
10000000000200001
10000000000000001
10020000000000001
10000000000000001
10000002000000001
10000000000000001                  1
10000000000000001
10000000000000001
10000000000000001
10000000N00000001
11111111111111111
