R 2000    00000000000000000000000600
NO      ./srcs/textures/redbrick.xpm
SO      ./srcs/textures/bluestone.xpm
WE      ./srcs/textures/greystone.xpm
EA      ./srcs/textures/wood.xpm
S       ./srcs/textures/barrel.xpm
C 0050,150,222
F 70, 200, 110

        1111111111111111111111111
        1000000100000000000000001
        1211222221112222000000001
        12212222222222220000N0001
111111111211222221112222000000001
122222222211222221112111000011111
11112111111111211122222202221
11112111111111211121212202221
11222222112121211122222202021
12222222022222221122222212221 
12222222222221221121221212221        1
11222221112121211111211112221
11111111111111111111111111111
11111111111111111111111111111
11112111 1112121 121111212221
11111111 1111111 111111111111
11
