EA ./srcs/textures/greystone.xpm
F   22 ,   120,    1

WE ./srcs/textures/redbrick.xpm
NO ./srcs/textures/wood.xpm

SO ./srcs/textures/bluestone.xpm
S ./srcs/textures/barrel.xpm
C  5,  150,  155


R     800     600


11111111111111111111111111111111111111111
10001000100010000000000000000000000000001
10101110101010111111111111101111111111111
10100010101010000000000010101000100000001
10111010101011101111111010101010101111101
10001000101000100000100010001010100010001
11101111111110111110101111101010111010111
10100000001000100000101000101010100010001
10111011101011101111101010101110101111101
10001000100000001000001010100000101010001
10101110111111101011111011111111101010111
10100000100000101010000000001000001010001
10111011101110101110111110101111101010101
10100010001000100000100000100000001010101
10101110101011111111111111111111111011101
10100010101000100000000010000000001000101
10111011101110100200000010111111101010101
10100010001000100000000010100000100010101
11101110111110100000N00010101111101010101
10100000100000100000000000101000001010101
10101011101111100000000010101010111110101
10101000100000100000000010101010001000101
10101111111110100000000010101011101011101
10001010000010100000000010101010001000101
11111010111110111111111110101010101110101
10001000000010100000000010101010100010101
11101111111010111011111010101010111110101
10001000001010001000001010101010100000101
10101011101010101111101110101110101111101
10100010001000100010001000100010101000101
10111110111010111010111011111010101110101
10101000100010001010100010001010100000101
10101011111111101010101010101010111110101
10001010000000101010101010101000001000101
11101010111011101010101110101111101011111
10001010001000001010001000101000101010001
10111011101111111011111011101011101011101
10100010001010000010001000100010001000101
10101111101010111110101011111110111110101
10100000000010000000100000000000100000001
11111111111111111111111111111111111111111
